16
13 13 13 13 13 13 13 13 13 13 13 13 13 13 13 13 
13 0 0 0 13 13 13 13 13 0 0 13 22 22 22 13 
13 0 0 0 0 0 0 0 13 13 13 13 0 0 22 13 
13 0 0 0 13 13 13 0 0 0 0 0 0 22 22 13 
13 13 0 13 13 27 13 0 13 13 13 13 13 13 13 13 
13 13 0 13 27 28 13 0 13 13 13 4 13 0 17 13 
13 13 0 13 28 0 13 0 13 13 13 0 13 0 17 13 
13 13 0 13 27 0 0 13 0 11 13 0 0 0 18 13 
13 13 0 13 0 0 0 0 0 11 13 0 13 0 17 13 
13 13 0 13 0 0 13 13 13 13 13 0 13 13 13 13 
13 13 0 0 0 0 0 0 0 0 0 0 0 10 10 13 
13 13 13 0 13 13 0 13 13 13 0 13 13 10 10 13 
13 4 0 0 13 12 0 12 13 24 0 0 13 13 13 13 
13 10 0 0 13 12 0 12 13 24 0 0 0 0 0 13 
13 10 10 4 13 12 12 12 13 24 25 24 13 0 0 13 
13 13 13 13 13 13 13 13 13 13 13 13 13 13 13 13 
2 2
