30
24 24 24 24 24 24 24 24 24 24 24 24 24 24 24 24 24 24 24 24 24 24 24 24 24 24 24 24 24 24 
24 0 0 0 24 24 24 24 24 24 24 24 24 24 25 25 24 24 24 24 24 24 24 24 24 24 24 24 24 24 
24 0 0 0 0 0 0 0 0 0 0 0 0 0 0 0 0 0 0 0 0 0 0 0 0 0 0 0 24 24 
24 0 0 0 24 24 24 0 24 24 24 24 24 25 24 24 24 24 24 0 24 24 24 24 24 24 24 0 24 24 
24 24 0 24 0 0 24 0 24 17 17 17 18 17 18 17 17 17 24 0 24 27 11 11 11 27 24 0 24 24 
24 24 0 24 0 0 24 0 24 17 0 0 0 0 0 0 0 17 24 0 24 27 0 0 0 27 24 0 24 24 
24 24 0 24 25 25 24 0 24 0 0 0 0 0 0 0 0 17 24 0 24 27 0 0 0 27 24 0 24 24 
24 25 0 0 0 0 0 0 0 0 17 17 18 17 18 17 17 17 24 0 24 28 0 0 0 27 24 0 24 24 
24 25 0 24 24 24 24 0 24 24 24 24 24 24 24 24 24 24 24 0 24 28 0 0 0 27 25 0 24 24 
24 24 0 24 0 0 24 0 24 23 23 22 22 22 23 23 23 23 24 0 24 28 0 0 0 27 24 0 24 24 
24 24 0 24 0 0 24 0 24 23 0 0 0 0 0 0 0 23 24 0 24 28 0 0 0 27 24 0 24 24 
24 24 0 24 0 0 24 0 24 23 0 0 0 0 0 0 0 23 24 0 24 27 0 0 0 27 24 0 24 24 
24 24 0 24 0 0 24 0 24 23 0 0 0 0 0 0 0 23 24 0 24 27 0 0 0 27 24 0 24 24 
24 24 0 24 24 24 24 0 24 0 0 0 0 0 0 0 0 23 24 0 24 27 0 0 0 27 24 0 24 24 
24 24 0 0 0 0 0 0 0 0 23 23 23 22 22 22 23 23 24 0 24 27 0 0 0 27 24 0 24 24 
24 24 0 24 24 24 24 0 24 24 24 24 25 25 24 24 24 24 24 0 24 27 27 0 27 27 24 0 24 24 
24 24 0 24 0 0 0 0 0 0 0 0 0 0 0 0 0 0 0 0 24 24 24 0 24 24 24 0 24 24 
24 24 0 24 0 0 0 0 0 0 0 0 0 0 0 0 0 0 0 0 0 0 0 0 0 0 0 0 0 24 
24 0 0 0 0 0 0 0 0 0 0 0 0 0 0 0 0 0 0 0 0 0 0 0 0 0 0 0 0 24 
24 0 0 0 0 0 0 0 0 0 0 0 0 0 0 0 0 0 0 0 0 0 0 0 0 0 0 0 0 24 
24 0 0 0 0 0 0 0 0 0 0 0 0 0 0 0 0 0 0 0 0 0 0 0 0 0 0 0 0 24 
24 0 0 0 24 24 24 24 0 0 24 24 24 24 0 0 0 0 0 0 0 0 0 0 0 0 0 0 0 24 
24 0 0 0 24 1 1 1 0 0 1 1 1 24 0 0 0 0 0 0 0 0 0 0 0 0 0 0 0 24 
24 0 0 0 24 1 0 0 0 0 0 0 1 24 0 0 0 0 0 0 0 0 0 0 0 0 0 0 0 24 
24 0 0 0 24 1 0 0 0 0 0 0 1 24 0 0 0 0 0 0 0 0 0 0 0 0 0 0 0 24 
24 0 0 0 24 1 1 1 4 4 1 1 1 24 0 0 0 0 0 0 0 0 0 0 0 0 0 24 24 24 
24 0 0 0 24 24 24 24 24 24 24 24 24 24 0 0 0 0 0 0 0 0 0 0 0 0 0 0 0 24 
24 0 0 0 0 0 0 0 0 0 0 0 0 0 0 0 0 0 0 0 0 0 0 0 0 24 0 0 0 25 
24 0 0 0 0 0 0 0 0 0 0 0 0 0 0 0 0 0 0 0 0 0 0 0 0 24 0 0 0 24 
24 24 24 24 24 24 24 24 24 24 24 24 24 24 24 24 24 24 24 24 24 24 24 24 24 24 24 24 24 24 
2 2